1111111111111
1P000000000C1
1000011111001
1000CCC000001
10C000000E011
1111111111111
