1111111111111
1P0000000C001
11111111110C1
1000000000011
10C1111111111
10000000000E1
1111111111111
